111111111
1P0000011
1110001C1
1E0000011
111111111
