111111111
1PP000011
100000BC1
1E0000011
111111111
