111111111111111111
111101H101H1010111
111101010101010111
1P00000000000000E1
11110101H101H1H111
1111H1010101010111
111111111111111111
