111111111111111111111111111111
1E0000000B0000C00000C000000001
101001010010000101001000001011
101001001001010001001000001011
1P000000000C000000000000000001
111111111111111111111111111111
