111111111
1P0000001
110000BC1
1E1000001
111111111
