111111111
1P0000011
111000BC1
1E0000011
111111111
