111111111
1P0000001
100000BC1
1E0000001
111111111
