1111111111111111111111111111111
1E00000B11111111111111111111111
1P00000000000000000000000000000
1111111111111111111111111111111
1E00000000C00000C00000000111111
10100100001010010000010110000001111111111111111111111111111111111111111111111111111111111111111111111111111111111111111111111111111111111
